elysian_fortification_pgroup = {
	2547 938 937 4877 2549 2011 2552 2553 955 2023 956 2639
	# 953 952 950 2550 2554 957
}

thorfinn_bay = {
	980 981 982 983 984 985 986 994 995 996 997 2570 2571 2572 2573 2574 2575 2576 2577 2578 2582 2583 
}


european_seas_lakes = {
	1323 1322 1324 1321 1320 1319 1317 1316 1315 1932 1314 1318 1312 1313 1311 1310 1309 1308 1307 1305 1304 1303 1302 1298 1297 1300 1301 1299 1296 1295 1294
	1293 1472 1471 1292 1566 1291 1290 1278 1276 1277 1275 1289 1563 1274 1288 1287 1286 1283 1284 1285 1272 1271 1270 1269 1279 1280 1282 1476 1478 1477 1480
	1475 1473 1281 1975 1268 1266 1929 1474 1265 1264 1263 1652 1267 1259 1258 1257 1927 1255 1928 1926 1256 1254 1253 1252 1886 1887 1250 1251 1977 1883 1885
	1884 1261 1262 1260 1889 1890 1325 1891 1892 1894 1893 1326 1976 1328 1329 1479 2953 4235 4139 4140
}

world_lakes = {
	1250 1251 1260 1261 1262 1325 1326 1327 1648 1649 1650 1651 1653 1654 1655 1656 1657 1658 1664 1665
	1883 1884 1885 1886 1887 1888 1889 1890 1891 1892 1893 1894 1895 1896 1897 1898 1899 1900 1902 1903 1904 1905 1906 1907
	1908 1909 1910 1911 1912 1913 1914 1915 1916 1917 1918 1919 1920 1921 1922 1923 1976 1977 2000 2001 2471 2953
	4132 4133 4134 4135 4136 4137 4138 4139 4140
	4235
}

#Changed to east coast
mesoamerican_landing = {
	2647 2630 2631 2650 845 2651 2633 2652 2634 2632 2499 2668 858 2641 848 846 843 2636 2637 840 838 2660 2663 836 2664 835 2665 888 884 4598 4589 4593 4592 4597 4595 2819
}

mesoamerica_pgroup = {
	4578 858 856 4643 4645 857 2642 4642 2617 2621 2657 4576 854 853 2615 4641 4640 848 2641 4598 850 2628 2644 4583 4582 852 2626 4570 4571 4572 2622 2623 2624 4573 4574 851 2643 4575 4579 4580 2627 2645 2648 847 849 2646 4581 844 2629 4584 2630 2631 2647 2635 2638 2649 4585 4586 845 2632 2650 846 2633 2651 4590 2634 2652 4588 4591 842 843 2636 4589 4594 839 841 2653 4587 2637
}

nhs_provinces_around_lakes = {
	990 993 2585 989 2670 987 2587 2586 988 2671 1001 2015 1007 910 2517 2518 911 914 915 942 2522 945 2521 944 946 947 954 958 959 960 961 2559 2584
}

to_mississippi_trade_node = {
	2483 5411 5385 5373 5379 2019 5381 2489 5386 5380 5382 5383 5405 5374 5403 2020 5400 2490 5402 5401 5418 5417 5416 5415 5384 5399 5397 5398 5396 5409 2606 2604 2605 2603 2018 2607 2003 5378 2487 2488 5404
}

to_carribean_trade_node = {
	484 485 2656 486 2654 2655 488 489 490 2658 2659 487 481 491 492 482 483 493 494 495 496 1881 497 498 499 500 501 1516 4624 4622 4623 4619 4618 4620 4621 927 2534 928 4625 4626 2535 926 2536
}

to_chesapeake_bay_trade_node = {
	1500 937 2545 938 2546 2547 950 952 2550 953 969 2554 956 957 962 2023 963 965 2558 2639 967 2010 2560 966 968 2561 970 2562 4874 4877 2013 5377 932 2543 2542 929 2539
}

to_ivory_coast_trade_node = {
	1164 1165 1166 1096 1793 2241 1466 1097 1098 1118 1119 1151 1163 2242 1168 1306 4078 4079 4080 1126 1139 1141 2257 2258 1147 2289 2290 2294 1111 1112 1113 1116 2239 1114 1117 2238 1167 1171 1172 1174 
}

to_cape_of_good_hope_trade_node = {
	1460 789 833 1175 1176 1177 1178 1179 1180 1181 1182 1173 1800 2856 2864 2880 4781 4782 4783 4784 
}

to_zanzibar_trade_node = {
	1448 788 1100 1102 1103 1183 1186 1192 1193 1194 1195 1196 1197 1198 1199 1200 1201 1202 1203 1204 1792 2796 2774 4020 4021 4022 4023 4024 4025 4026 4027 4028 4029 4030 4031 4032 4049 
}

to_gulf_of_aden_trade_node = {
	2324 2775 2782 2783 2786 2788 2789 2790 2793 2794 2795 2024 1205 1206 1209 1212 1215 1230 2765 2773 2792 2784 1211 2764 2787 1232 1331 1779 2768 401 2341 2342 402 1099 4284 387 2346 4279 390 2344 4281 388 2345 4280 386 391 4282 389 2343 4283 1328 1329 1330 4333 4346 
}

to_alexandria_trade_node = {
	1234 2322 2323 364 379 1854 384 2329 2330 383 2328 4268 4269 385 2331 2332 4277 4278 380 381 2327 365 2315 2320 2321 1233 2318 4323 358 362 363 361 2316 4316 4317 359 2317 4318 360 1231 2319 4319 4320 356 357 2325 2326 4321 4322 
}

to_tunis_trade_node = {
	355 339 340 341 350 351 352 353 354 1882 2448 2449 2450 2451 2452 2453 2454 2455 2456 2457 2458 2472 2473 2474 2954 4566 4567 
}

to_sevilla_trade_node = {
	206 207 208 1746 215 216 231 232 1293 217 218 219 221 222 223 224 225 226 227 228 229 230 334 335 367 1745 1747 1748 1749 1751 1851 2754 2755 2751 4150 4546 4547 4548 4551 4552 4553 4554 4555 4556 4558 4561 4563 368 366 4565 4787 4788 4789 
}