elysian_fortification_pgroup = {
	2547 938 937 4877 2549 2011 2552 2553 955 2023 956 2639
	# 953 952 950 2550 2554 957
}

thorfinn_bay = {
	980 981 982 983 984 985 986 994 995 996 997 2570 2571 2572 2573 2574 2575 2576 2577 2578 2582 2583 
}


european_seas_lakes = {
	1323 1322 1324 1321 1320 1319 1317 1316 1315 1932 1314 1318 1312 1313 1311 1310 1309 1308 1307 1305 1304 1303 1302 1298 1297 1300 1301 1299 1296 1295 1294
	1293 1472 1471 1292 1566 1291 1290 1278 1276 1277 1275 1289 1563 1274 1288 1287 1286 1283 1284 1285 1272 1271 1270 1269 1279 1280 1282 1476 1478 1477 1480
	1475 1473 1281 1975 1268 1266 1929 1474 1265 1264 1263 1652 1267 1259 1258 1257 1927 1255 1928 1926 1256 1254 1253 1252 1886 1887 1250 1251 1977 1883 1885
	1884 1261 1262 1260 1889 1890 1325 1891 1892 1894 1893 1326 1976 1328 1329 1479 2953 4235 4139 4140
}

world_lakes = {
	1250 1251 1260 1261 1262 1325 1326 1327 1648 1649 1650 1651 1653 1654 1655 1656 1657 1658 1664 1665
	1883 1884 1885 1886 1887 1888 1889 1890 1891 1892 1893 1894 1895 1896 1897 1898 1899 1900 1902 1903 1904 1905 1906 1907
	1908 1909 1910 1911 1912 1913 1914 1915 1916 1917 1918 1919 1920 1921 1922 1923 1976 1977 2000 2001 2471 2953
	4132 4133 4134 4135 4136 4137 4138 4139 4140
	4235
}

#Changed to east coast
mesoamerican_landing = {
	2647 2630 2631 2650 845 2651 2633 2652 2634 2632 2499 2668 858 2641 848 846 843 2636 2637 840 838 2660 2663 836 2664 835 2665 888 884 4598 4589 4593 4592 4597 4595 2819
}

mesoamerica_pgroup = {
	4578 858 856 4643 4645 857 2642 4642 2617 2621 2657 4576 854 853 2615 4641 4640 848 2641 4598 850 2628 2644 4583 4582 852 2626 4570 4571 4572 2622 2623 2624 4573 4574 851 2643 4575 4579 4580 2627 2645 2648 847 849 2646 4581 844 2629 4584 2630 2631 2647 2635 2638 2649 4585 4586 845 2632 2650 846 2633 2651 4590 2634 2652 4588 4591 842 843 2636 4589 4594 839 841 2653 4587 2637
}

nhs_provinces_around_lakes = {
	990 993 2585 989 2670 987 2587 2586 988 2671 1001 2015 1007 910 2517 2518 911 914 915 942 2522 945 2521 944 946 947 954 958 959 960 961 2559 2584
}

to_mississippi_trade_node = {
	2483 5411 5385 5373 5379 2019 5381 2489 5386 5380 5382 5383 5405 5374 5403 2020 5400 2490 5402 5401 5418 5417 5416 5415 5384 5399 5397 5398 5396 5409 2606 2604 2605 2603 2018 2607 2003 5378 2487 2488 5404
}

to_carribean_trade_node = {
	484 485 2656 486 2654 2655 488 489 490 2658 2659 487 481 491 492 482 483 493 494 495 496 1881 497 498 499 500 501 1516 4624 4622 4623 4619 4618 4620 4621 927 2534 928 4625 4626 2535 926 2536
}